00000000000000000000000000000000
00000000000000000000000000000000
00000000100000000000000000000000
00000000000000000000000000000000
00000000030000000000000000000000
00000020112000000000000000000000
00000000000000000000000000000000
00000000000000000000000000000000
30303030303030303030303030303030
30303030303030303030303030303030
