00000000000000000000000000000000
00000000000000000000000000000000
00000000100000000000000000000000
00000000000000000000000000000000
00000000000000000000000000000000
00000020112000000000000000000000
00000000000000000000000000000000
00030000040000000000000000000000
30303030303030303030303030303030
30303030303030303030303030303030
